23
14
30 30 30 30 30 30 30 30 30 30 30 30 30 30 30 30 30 30 30 30 30 30 30   
30 30 30 30 30 30 30 30 30 30 30 30 30 30 30 30 30 30 30 30 30 30 30   
1  1  1  30 1  30 1  30 1  30 30 30 30 30 30 30 30 30 30 30 30 30 1    
18 18 18 18 18 18 18 18 18 5  30 30 30 30 30 30 30 30 30 30 30 9  19  
6  30 30 30 30 30 30 6  30 30 30 30 30 30 30 30 30 30 1  30 30 10 20  
7  30 30 30 30 30 30 7  30 30 30 30 30 1  30 30 30 12 19 30 1  10 20  
8  1  30 30 1  30 1  8  1  30 1  30 30 12 19 30 30 17 22 9  13 13 20 
18 18 5  4  18 18 18 18 18 18 18 5  30 17 22 30 30 30 30 11 21 15 22 
30 6  30 30 30 6  30 30 30 6  30 30 30 30 30 30 30 30 30 30 30 30 30  
30 7  30 30 30 7  30 30 30 7  30 30 30 30 30 30 30 30 30 30 30 30 30  
30 7  30 30 30 7  30 30 30 7  30 30 30 30 30 30 30 30 30 30 30 30 30
1  8  30 1  1  8  1  30 30 8  1  30 30 30 30 30 30 30 30 30 30 1  1 
18 18 18 18 18 18 18 18 18 18 18 18 5  1  30 1  1  30 1  9  13 13 19  
13 13 13 13 13 13 13 13 13 13 13 13 13 13 13 13 13 13 13 13 16 21 20